############.................
@..........#.................
#######....#.................
#.......####.................
#$###$$.####...#........#....
#^.........#..#..........#...
########...#.................
########...#.........###.....
##.........#..#.......!#.....
#...######.#...#.....###.....
#.....##...#.................
#.....##..##.................
#.....##...#.................
#..........#############.####
###...#..#######--------.-.#
###...#..###.............#.<#
......#.......#.^^^^^^^^#^^.#
...######.....#############

