############.................
@..........#.................
#######....#.................
#>......####.................
#$###$$#####...#........#....
##.........#..#..........#...
#######^...#.................
########...#.........###.....
##.........#..#.......!#.....
#...######.#...#.....###.....
#.....##...#.................
#.....##..##.................
#.....##...#.................
#..........#############.####
###...#..#######--------.-.#
###...#..###.............#.<#
......#.......#.^^^^^^^^#^^.#
...######.....###############