...###
..##.#.####
.##..###..#
##....$...#
#...@..#..#
###..###..#
..#..#....#
.#d.##.#.##
.#......l#
#r.u...##
.#######