###################..........
..................#..........
.....@.....<^^^^^.#..........
############......#..........
#$.....##....######..........
#............<#..............
#............<#..............
######.####################..
....#>.<#####!.....#......#..
....#>.<#...#.......$###..#..
....#>.<#.#.#########.....#..
....#>....#.........#.....#..
..###############...#.....#..
..#$..............###.....#..
..#.#################.....#..
..#.......................#..
..##^^^^^^^^^^^^^^#########..
.............................