#############################
############>----------######
############>.#.........####
############>..$........#####
#.......########........#####
#..........#>...........#####
#.######...............@#####
#.######...#>........########
#..........#>........##!...$#
#..########.........####...##
#.....######............#...#
#.....######............#...#
#.....##$...................#
#..........##################
################............#
###...#..###................#
......#.....................#
...######.....#############

