############----------#######
##@.....####..........$######
#######.####.............####
#######.####............#####
##-----.########........#####
>......................######
>.#####..<##..........#######
>.#####..<##..........#######
#........<##............##..#
###########.........####...##
#......$!###............#...#
#.....######............#...#
#.....##....................#
#.......########.############
#######.....................#
###...#^^###................#
......#>...................$#
...######.....###############