&..........@................
###########.################
...........................<
.##########################.
............#...............
#...........................
>...........................
.#########################..
............#...............
...........................#
............................
...........................<
.##########################.
!...........................